province	prov
Eastern Cape	EC
EASTERN CAPE	EC
FREE STATE	FS
Free State	FS
GAUTENG	GP
Gauteng	GP
KWAZULU-NATAL	KZN
KwaZulu-Natal	KZN
Kwazulu-Natal	KZN
LIMPOPO	LP
Limpopo	LP
MPUMALANGA	MP
Mpumalanga	MP
NORTHERN CAPE	NC
Northern Cape	NC
NORTH WEST	NW
North West	NW
ALL	ALL
INTERNATIONAL	UNK
South Africa	UNK
WESTERN CAPE	WC
Western Cape	WC
